#############################################################################################################################################
#.....#...#.....#...#.........#...#.....#...........#.........#...................#.#.........#.......#.........#.......#.......#.........#E#
#.#.#.#.###.#.#.#.#.#.###.###.###.#.#.#.###.#######.#.#.#####.#.#########.#####.#.#.#.#.###.#.#####.#.###.#####.#.#####.#.###.#.#.#######.#.#
#.#.#.............#...#...#.#...#.#.#.....................#...#.#.......#.#.....#.#.....#...#.......#...#.....#...#...#...#.#...#.....#.#.#.#
#.#.#.#####.#.#.#.#####.###.###.#.#.#.#.#.###.#.#.#.#####.###.###.#####.###.#####.#####.#.#############.#.###.#.###.#.#####.#.###.###.#.#.#.#
#.#.#.....#.#.#.#.#.#...#.....#.#...#.#.#.#.#...#...#...#...#...#.....#.....#...#.....#.#...#...#.....#.#...#.#.....#.........#.#...#.#.#.#.#
###.#####.#.#.###.#.#.###.###.#.#.###.#.#.#.#.#######.#.###.###.#.###.#########.#####.#.###.#.###.###.#.#.###.#.###############.###.#.#.#.#.#
#...#.....#.#.......#.#...#...#.#...#.#...#.#...#.....#...#.#.#.#.....#.................................#...#.#.....#.........#.....#.#.#.#.#
#.###.#####.#.###.###.#####.###.###.#.#####.###.#####.###.#.#.#.#.#####.#.#.#######.###.#.#.#.#####.#####.#.#.#.###.#####.###.#######.#.#.#.#
#.#.......#.#...#.#...#...#.....#...#...#.............#.#...#...#.#...#.#.#.#.....#...........................#...........#.#.....#...#.....#
#.#######.###.#.###.###.#.###.###.#####.###############.#####.###.#.#.#.#.###.###.###.#####.###########.#.#################.#####.#.#.#######
#...#.........#.....#...#...#.#.....#.#.........#...........#...#...#.#.#...#.#...#.....#.#.#.....#.....#.............................#.....#
###.#.###############.#####.#.#####.#.#########.###########.###.#####.#.###.#.#.#######.#.#.###.#.#.###.#.#####.#.#####.###.#########.#.###.#
#...#...#.#.....#.........#.#.....#.#.........#.#.............#...#...#.#.#.#.#.......#...#.....#.#...#.#.#...#...#...#...#...........#.#...#
#.#####.#.#.###.#.###.#####.#####.#.#####.#.###.#.###############.#.###.#.#.#.#######.###.#.#####.#.#.#.#.#.#.#####.#.###.###########.#.#.#.#
#.....#...#...#.#.#.#.......#...#.#.......#.#...#...............#...#...#.#.#.#.#...#...#...#.....#.#.#.#...#...#...#...#...#...........#...#
#.###.###.###.#.#.#.#.#######.#.#.#######.###.###.###########.#########.#.#.#.#.#.#.###.###.#.#.###.#.#########.###.#.#####.#.#.#####.#####.#
#.#.#.#...#...#...#.#.#.....#.#.#.#.#...#.#...#.#.....#.....#.#.......#.....#.#...#.#...#.....#...#.#.........#...#.#.....#...#...........#.#
#.#.#.###.#.#######.#.#.###.#.#.#.#.#.#.#.#.###.#####.#####.#.#.#.###.#####.#.#####.#.###########.#####.#####.###.#.###.#######.#######.#.#.#
#...#...#.#.#.......#.#...#...#.#.#.#.#...#.#.......#...#...#...#...#...#...#.#...#.#...........#.....#.#.......#.#...#.....#...............#
###.###.#.#.#######.#.###.#####.#.#.#.#####.###.###.###.#.#.#.#####.###.#.###.#.#.#.###########.#####.#.#########.#.#####.#.#.#.#####.#####.#
#...#...#.#.#.....#.#...#.#...#.#.#...#...#...#.#...#...#.......#...#.#...#...#...#...#...#...#.....#.#.....#.....#.#.....#.#...#...#.#...#.#
#####.#####.#.###.#.###.#.#.#.#.#.###.###.###.#.#.###.#####.###.#.###.###.#.###.#.#.#.#.#.#.#.###.###.#.###.#.#######.#####.#.#.#.#.#.#.#.#.#
#.....#.....#...#.#...#.#.#.#...#...#.......#.#.#.........#...#.#.#.....#.#.....#...#...#...#...#.....#...#.#...#...#.#...#...#...#...#.#.#.#
#.#####.#######.#.#.###.#.#.#######.#######.#.#.#########.###.#.#.#.#.#.#.#################.###.###.###.###.###.#.#.#.#.###.#.#########.#.#.#
#.....#.#.......#...#.....#.......#.....#...#.#...#.....#.....#.#.#.#...#.#...........#.....#.....#.....#...#.#...#.#.#.....#...........#...#
#.###.#.#.#.###.###.#.###.###.#########.###.#.#####.###.#######.#.#.###.#.###.#.#####.#.#####.###.#######.#.#.#####.#.###.#.#.#.#.#.###.#####
#.#.#...#.#...#...#.....#.#...#.......#...#.#.....#...#.....#...#.#...#.#...#.#.#.....#...#...#.#.....#...#...#.....#...#.#.....#.#...#.#...#
#.#.#########.#.#.#####.#.#####.#.###.###.#.#.###.#.#######.#.###.###.#.###.#.#.###.#####.#.#.#.#####.#.#######.#####.#.#.#.#####.###.#.#.#.#
#.............#.#.....#.#.....#.#.#.#.....#...#...#.#.........#.#.#...#.#...#.#.....#...#.#.#.#.......#.#.....#...#...#.#.#.....#.#...#.#.#.#
#.###########.#.#####.#.#.###.#.#.#.###.#.#####.###.#.#######.#.#.#.###.#.#######.#.#.###.#.#.#.#######.#.###.#.#.#####.#.###.#.#.#.#.###.#.#
#.#...#...#...#.#.#.....#...#...#.#.....#...........#.....#.#.#.#.#.#...#.........#...#...#...#.....#.......#...#...#...#...#.#...#.#.#...#.#
###.#.#.#.#.#.#.#.#.#############.###########.#.#########.#.#.#.#.#.#########.#######.#.###.###.###.#########.#####.#.#####.#.###.#.###.###.#
#...#.#.#...#.#.#...#...........#.............#.......#...#.#.#.#.#.......#...#.....#.#.#.#...#.#...#.......#.#.....#...#...#.#...#.......#.#
#.###.#.#####.#.#####.#########.###.###.#####.#######.#.###.#.#.#.#.###.#.#.###.###.###.#.#.#.#.#.###.#####.#.#.#######.#.###.#.#########.#.#
#.#.....#...#.#.#...........#.#...#...#.....#.#.......#.#.....#.#.#.....#.......#.#...#.#.#.#.#.....#...#...#.#...#.....#...#.#.....#...#.#.#
#.#######.#.#.#.#.#########.#.###.###.#####.#.#.#######.#####.#.#.#.#.#######.###.###.#.#.#.#.#####.###.#.###.###.#.#######.#.#####.#.#.###.#
#.........#.#.#.#...#.#...#.....#.#.#...#...#.#.......#.....#...#...#.#.....#.#.....#...#...#...#...#...#.#.....#...#.....#.#...#.....#.....#
#.#########.#.#.###.#.#.#.#.#####.#.#.###.###.#.#######.###.#######.###.###.#.#####.#####.###.#.###.#.###.#.###.#####.###.#.###.#.#.###.#####
#...#...#...#.....#...#.#...#.....#...#...#...#.#.....#.#...#.....#.......#...#.....#...#.#.......#...#...#...#.#...#.#.#...#...#.#...#.#...#
###.#.###.###.#.#####.#.###.#.#####.###.###.#####.#.#.#.#.#.#.###.#######.#####.#####.#.#.#.#.###.#####.#####.#.#.#.#.#.#####.###.#.#.###.#.#
#.#...#...#.....#.....#.#.#.#.....#.#.#...........#.....#.#.#...#...#...#.....#.........#.#.#.....#...#.......#...#.#.......#.#...#.#.#...#.#
#.###.#.#.###.#.#.#####.#.#.#####.#.#.#################.#.#####.###.#.#.#####.#######.#.#.#.#######.#.###########.#########.#.#.###.#.#.###.#
#...#.#.#.#...#.#.#...#.#.#...#...#.....#...........#.....#.....#.#.#.#...#.........#.#...#.....#...#.......#.....#.......#...#.....#.....#.#
#.###.#.#.#.#.###.#.#.#.#.###.#.#######.#.#####.###.#.#####.#####.#.#.###.#########.#.#.#####.#.#.#######.#.#######.#.#####.#######.###.###.#
#.#...#.#.#.#.....#.#...#...#.#...#...#...........#.#...#...#.....#...#.#...#.....#...#.#.#.....#.#.......#.........#.......#.....#.........#
#.#.###.###.#.#####.#.#####.#.###.#.#.#.#########.#.#.#.#.#######.#.#.#.###.#####.###.#.#.#.#####.###.###.#############.#####.###.#.###.###.#
#.#...#.#...#.......#.....#.......#.#.....#...#.#.#...#...#.....#.#.#.#...#...#...#...#...#.#...#...#.#.......#.......#.....#.#...#...#...#.#
#.###.#.#.###.#####.#.###.#######.#.#####.#.#.#.#.#########.###.#.#.#.#.#.###.#.#.#.#######.#.#.###.###.#####.#.#####.#######.###.#.#.#.#.#.#
#.....#.....#.#...#.#.#.#.#...#.........#...#.#.#.#.....#.....#...#.#...#...#.#.......#...#.#.#...#...#.....#.#...#.....#...#...#.....#.#...#
#.###########.#.###.#.#.#.#.#.#####.###.#####.#.#.#.#####.###.#####.#######.#.#######.#.#.#.#.#.#####.#####.#.###.#####.#.#.###.###.###.###.#
#...#.....#...#.....#.#.#...#.#.......#...#.....#.#.........#.....#.#...#...#.#...#...#.#.#...#.#...#.......#...#.....#.#.#...#.#.....#.#...#
###.###.###.#######.#.#.#####.#.#######.#.#.#####.#.#.###########.#.#.#.#.###.#.#.#.###.#.#####.#.#.###########.#####.#.#.###.#.#.#.###.#.#.#
#.#...#.#...#.....#.#...#...#.....#...#.#.#.#.....#.#.#.......#...#...#...#...#.#.#.....#.....#.#.#.........#...#...#.#...#...#.#.......#...#
#.#.#.#.#.#.#.###.#####.#.#########.#.###.###.#####.#.#.#####.#.#.#########.###.#.###########.#.#.#########.#.###.#.#.#####.###.#.#.###.###.#
#.....#.#.#.#.#...#.....#.......#...#.....#...#.......#.#.....#.#.......#.#.....#.#.#.........#...#.......#...#...#.#.#.....#...#.........#.#
#.#####.#.#.#.#.###.#####.###.#.#.#######.#.#####.#####.###.###.#######.#.#######.#.#.#####.#####.#######.#####.#####.#.#######.#######.#.#.#
#...#...#.........#.#.....#...#.#.#.....#.#.....#.#...#...#.....#.#.....#.#.....#.#...#.........#...#...#.......#.....#.#.......#.#.....#.#.#
###.#.#.#.#.#.###.#.#.#####.#####.#.#.#.#.#####.#.###.###.#######.#.#####.#.###.#.#.#####.#####.###.#.#.#.#.#####.#####.#####.#.#.#.###.#.#.#
#.....#.#.#.....#...........#.....#.#.#.#.#.....#.....#...#...#...#.#...#...#...#.#.......#.....#.#...#.#.#.#...#...#.........#.....#.#.#.#.#
#######.#.#.#################.#####.#.###.#.#######.#.#.###.#.#.#.#.#.#.#.#.#.###.#########.###.#.#####.#.###.#.#.#.###.#######.#####.#.#.#.#
#.....#.#...#...............#...#.#.#.#...#...#.....#.#.......#.#.#...#.#.#.#.#...........#.....#.....#.#.#...#.#.#...#.......#.#.....#...#.#
#.###.#####.#.#####.#####.#.###.#.#.#.#.#####.#.###.#.#######.#.#.#.#.#.#.#.#.###########.#.#.#####.#.#.#.#.###.#####.#.#####.#.#.###.#####.#
#.#...#...#...#.......#...#...#.#.#.#...#...#.#.#...#...#...#.#.#.#...#...#.#...............#.....#.#.....#.#.#...#...#.#...#.#...#...#.....#
#.#.###.#.#.#.#.#.#.#.#.#.###.#.#.#.#####.#.#.#.#.#####.###.#.#.#.#.#.#####.###.#.#########.###.#.#.#######.#.###.#.###.#.#.###.###.###.###.#
#.#.#...#...#.#.#...#...#.#.#.#.#.#...#...#.#.#.#.#.........#.#...#.#.......#.#...#.......#.#...#.#.#.......#...#.#...#...#.........#.#.#...#
#.#.###.###.###.#########.#.#.#.#.###.#.###.#.#.###.#####.###.#.###.#.#.#####.#####.#####.#.#.###.###.#######.#.#.###.#########.#.#.#.#.#.#.#
#.#.....#.......#.........#...#.#...#.#.#...#.......#...#.#...#...#.#.#...........#.....#...#.#.#.....#.........#...#.#...#.....#.#.#...#...#
#.#######.#######.#########.###.#.#.#.#.###.#.#######.#.###.###.#.#.#.#####.#.###.#####.#####.#.#######.###.#######.#.#.#.#.###.#.#.#######.#
#.#.....#...#.#...#...#.....#.....#.#.#.#...#.#.....#.#.....#.#.#...#.#...#.#.........#.#.....#.....#...#.#.........#.#.#...#.....#.......#.#
#.#.###.###.#.#.###.#.#.#########.#.#.#.#.#.#.#.#.#.#.#######.#.#####.#.#.###.#.#######.#.#####.###.#.###.#######.#.#.#.#######.#########.#.#
#.....#...#...#.#...#.#.#.....#...#.#...#.#...#...#...#.......#...#...#.#...#.#...#.....#.#...#.#.#...#.....#.......#.#.......#.........#...#
#.#####.#####.#.#.###.#.#.#.#.#.###.###.#.#####.#.#.###.#.###.###.#.#####.#.#.###.#.#####.###.#.#.#####.#.###.#.#####.#.#####.#.#####.#####.#
#...#...#.....#...#...#.#.#.#.#...#.#...#.....#.#.#...#.#...#.#...#.........#...#.#.......#...#.#.....#.#.....#.......#...#.#.......#.#.....#
#.###.#.#.#########.###.#.#.#.###.#.#.#######.#.#.#.#.#####.###.###############.#.#########.###.#.###.###.###########.###.#.###.###.#.#.#####
#.#...#.#.#.#.....#...#...#.#.....#.#.#...#.#.#.#.#.#...#.......#.....#.......#.#.....#...#.....#...#...#...........#...#.#.......#.#.#.....#
#.#.#####.#.#.#.#####.#####.#######.#.#.#.#.#.###.#.###.#.###.###.###.#######.#.#####.#.#.#.#####.#.###.#########.#####.#.#####.#.#.#.#.###.#
#.#.......#...#.#.....#...#.........#.......#...#...#...#...#.#...#...#.......#.#...#.#.#.......#.#.......#.......#.....#.......#...........#
#.#############.#.#####.#.###.#############.###.#####.###.#.#.#.###.###.#####.#.###.#.#.#####.#.#.###.###.#####.###.#######.###.#####.#.#.#.#
#.#...........#.#.......#.................#...#.....#.....#.#.#.#.#.#...#.....#.#...#.#...#.#.#.........#.....#...#.#.....#.....#...#...#...#
#.###.#######.#.###########.###.#######.#####.#####.###.#.#.#.#.#.#.#.#########.#.#.#.###.#.#.#####.###.#####.#####.#.###.#.#####.#.#.#.#####
#.....#.....#...#.........#...#...#...#...........#.....#.#...#.#...#.............#.#.......#.#...#...#.#...#.......#...#...#...#.#.#.#.....#
###########.###.#.#######.###.###.###.###########.#######.#####.#.#################.#.#.#.#.#.#.###.#.#.#.#############.#####.#.#.#.#.#.###.#
#.............#.#.#...#.#.#.#.#.#...#.#.....#...........#.#.....#.#.............#...#.#...#.#.....#.#.#.#.#.....#.....#.#.#...#...#.#.#...#.#
#.###.#######.#.#.#.#.#.#.#.#.#.###.#.#.###.#.#########.#.###.###.###.#.###.###.#.###.###.#.#.#.#.#.#.#.#.#.###.#.#.###.#.#.#######.#.#.#.#.#
#.#...#...#.#.#.#...#.#.....#.#.......#...#.#...........#...#.#.#.#...#.#...#.#.#...#.#...#.#.#.....#.#...#...#.#.#.......#.#...#.#.......#.#
#.#.#.#.#.#.#.#.#####.#####.#.#####.#.###.#.###.#######.###.#.#.#.#.###.#.#.#.#.#####.#.###.#.#.#####.#.#.###.#.#.#.#####.#.#.#.#.###.#.#.#.#
#...#.#.#...........#.....#.#.......#.#.#.#.....#.....#...#...#...#.#...#.#.#.........#.#...#.#...#...#.#...........#...#.#...#...#.....#.#.#
#.#.###.#.#########.#####.#.#######.#.#.#.#######.###.###.#####.###.#####.#.#######.#.#.###.#.#####.#.#.#####.#.#####.#.#########.#.#.#.###.#
#.#.......#...#...#.#.....#...#...#.#.#.#.#.......#...#.....#...#.........#.#.....#...#.#...........#.#.#...#.#.......#.#.....#.............#
#.#.#####.#.#.#.#.#.#.#####.#.#.###.#.#.#.###.#####.###.#####.###########.#.#.###.#.###.#.#######.#####.#.#.#.#.#.#####.#.###.#.###.#.#.#.###
#.#...#...#.#...#...#.#.#.......#...#...#.....#.#...#.#.......#.........#.#...#...#.#...#.........#...#...#.#.#.....#...#.#.#.#.#...#...#...#
###.#.#.###.#########.#.#.#######.###.#.#######.#.###.#########.#######.#.#####.###.#.#######.#####.#.#.###.#.###.###.#.#.#.#.#.#.###.###.#.#
#...#.#...#.#.........#.#...#.....#.#...#.....#...#.............#.....#.#.....#.#...#.......#...#...#.#.#...#.#...#...#.#.#.#...#.#.#.#.#.#.#
#.#.#.###.#.#.#.#######.#.#.#.#####.#.###.#.###.#####.###########.#.#.#.#######.#.#########.###.#.###.###.###.#.###.#####.#.#####.#.#.#.#.#.#
#...#.....#.#.#.#...#.....#.#...#...#.#...#...#...........#.........#.#...#.....#.......#...#.....#.......#...#...#...........#.............#
#.#.###.###.#.#.#.#.#.#.###.###.#.#.#.#.#####.###########.#.#.#.#########.#.#######.#####.###.#####.#############.#####.#####.#.###.#.#.#.#.#
#.#.#...#...#.#.#.#.#...#...#...#...#.#.#...#.#.........#...#.#.#.......#.#.....#...#.....#...#.....#...........#...#...#...#.#...#...#...#.#
#.#.###.#.#####.#.###.#.#.###.#####.#.#.###.#.#.###.###.#####.#.#.###.###.#.###.#####.#####.#.#.#####.#########.###.#.#.#.#.#####.#.###.#.#.#
#.#...#.#.#.....#.....#...#...#.....#.#.....#.#.#.#...#.#.....#.#.#.#.#...#...#.......#.....#.#.#.........#...#.....#.#.#.#...#...#...#.#...#
#.###.###.#.#########.#.###.#####.###.#####.#.#.#.#.#.#.#.#.#####.#.#.#.#.###.#########.###.#.###.#######.#.#.#######.#.#.###.#.#####.###.#.#
#.#.#.....#...........#.#...#...............#.....#...#.#.#.#...#...#...#.#...#.....#.......#.#...#.....#...#...#.#...#.#.#.#...#...#.....#.#
#.#.#######.#########.#.#.#.#.#.#########.#########.#.#.#.###.#.###.#####.#.###.#####.#.###.#.#.###.###.#######.#.#.###.#.#.#####.#.#####.#.#
#...#.....#...#.....#.#.#.....#...#...#.#.#.........#...#.#...#.....#.#...#.#...#.....#...#.#...#...#.#.#...#.....#...#...#.....#.#...#...#.#
###.#.###.#####.###.#.#.#.#.#.###.#.#.#.#.#.#########.###.#.#########.#.#.#.#.#.#.###.#.#.#.#####.###.#.#.#.#.#######.#####.###.#.#####.#.#.#
#.#...#.#.#.....#.#.#.#.#.#.....#...#.#...#...#...#.#.#...#.....#.......#.#.#.#.....#...#.#...#...#...#.#.#.....#.....#.#...#.....#.........#
#.#####.#.#.#####.#.#.###.#####.#####.#.#####.#.#.#.#.#.#######.###.#####.#.#######.#.###.###.#.###.###.#######.#.#####.#.#.#####.#.#####.###
#.....#...#.#...#.....#.......#.....#.#.#...#...#.#...#.....#.#...#.....#.#...#.....#.#.#.#...#...#.....#.....#.#...#.#...#...#...#.#...#...#
#.#.###.###.###.#.#####.###.#######.#.#.#.#.#####.#.#####.#.#.###.#######.###.#.###.#.#.#.#####.#.#.#####.###.#####.#.#.#####.#.###.#.#.#.###
#.#...#.....#...#.#...#...#.#.....#.#.#...#.....#.#.#...#.#.#...#.#.....#...#.#.#...#.#.#.....#.#.#.......#...#.....#.#...#.#.#...#...#.#...#
#.###.#####.#.###.#.#.###.###.###.#.#.#########.#.#.#.#.#.#.#.###.#.###.#.#.#.#.#.###.#.#####.###.#####.#####.#.#####.###.#.#.###.#####.#.#.#
#.#.......#...#...#.#...#.#...#.#...#...#.....#...#...#...#...#...#.#.#...#.#...#.....#.....#...#.#.....#...#...#.......#...#.#...#...#.....#
###.#.#####.#.#.###.###.#.#.###.#######.###.#.###.#########.###.###.#.#.#.#.#######.###.###.###.#.###.###.#.#####.#####.###.#.#.###.#.###.#.#
#.............#.#.#.#.....#...#.......#...#.#...#.#...#...#.#...#...#.....#.......#.....#.#.#.#.#...#.#...#.#...#.........#.#.#.....#.#.....#
#.###.#.#.#.#.#.#.#.#########.#.#####.###.#.###.#.#.#.#.#.###.###.#######.#######.#.#.###.#.#.#.###.#.#.###.#.#.#########.#.#.#######.#.#.#.#
#.#.#.#.#...#...#.#.........#...#.....#...#...#...#.#...#.....#.#.......#...#.....#.#.#...#.#.#.#...#.#...#...#...#.....#...#...#...#.#.#...#
#.#.#.#.###.#####.#.#.###.#.#####.#####.###.#.#####.###########.#.#####.#.#.#.#######.#.#.#.#.#.#.###.###.#######.#.###.#######.#.#.###.###.#
#.#...#...........#.....#.#.....#...#.#.#.......#...#...#...#.....#...#.#.#.#.........#.#.#.#.#.#...#.#.....#...#.....#.......#.#.#.#...#...#
#.###########.#########.#.#.###.###.#.#.#########.###.#.#.#.#.###.###.#.###.#.#####.###.#.#.#.#.#.#.###.#####.#.#####.#######.#.#.#.#.###.#.#
#.....#.....#.#.......#.#...#...#...#.#...............#.#.#.#.#.......#...#...#...#.....#...#.#.#.#.....#...#.#...............#...#.#.#...#.#
#.###.#.#.###.#.#####.#.#####.###.###.#############.#.###.#.#.#.#.#.#.###.#####.#.###.#######.#.###.#####.#.#.###############.#.###.#.#.###.#
#...#...#.....#...#...#.....#.#...#...#...........#.#.....#.#.#.#...#.#.#.....#.#...#.........#...#...#...#.#...#.......#.....#.#...#...#...#
###.#####.#####.#.#.#########.#.#####.#.#########.#.#######.#.###.###.#.###.#.#.###.#############.#####.###.###.#.#####.#.#.###.#.#######.#.#
#...#.......#.....#.#.......#.#.#.....#.#.#...#...#.#.....#...#...#...#.....#...#.#...#.........#.#.....#.#...#.#...#.#...#.....#.........#.#
#.###.###.#.#.###.#.#.#####.#.#.###.###.#.#.#.#.###.#.#########.###.###.#########.###.#.#######.#.#.#####.###.#.###.#.###########.#.#######.#
#.#.......#.#.....#...#.......#...#...#.#.#.#.#.....#.#.......#.#.#.#...........#...#...#.......#...#.......#...#.#...#...............#.....#
#.#######.#.#####.#####.#####.###.###.#.#.#.#.#######.#.###.#.#.#.#.#######.###.#.#.#####.#.#######.#.###.#.#.###.###.#.#########.#.#.#.###.#
#.........#.#...#...#.......#...#...#.#.#...#.............#.#...#.#.#.......#...#.#.....#.#.........................................#...#.#.#
#########.#.#.#.###.#########.#.###.#.#.###.###############.#####.#.#.#########.#.###.#.#.###.#####.#####.###.#.#.###.#.###.#.#.#.#.#####.#.#
#.........#.#.#...#.........#.#.....#.#...#.......................#.#.........#.#...#.#.#...#.#...........#.....#.#...#...#...#.#.....#.....#
#.#######.#.###.#.#########.#.#######.###.###########.###.###.#.###.#.#######.#.#.###.#.###.#.#.#.#.#.#.#.###.#####.###.#######.#.#.#.#.###.#
#.......#.#.....#.#.........#.........................#.#.....#...#.#.....#...#.#.#...#...#...#.#...#.#.#.........#...#.#.......#...#.#.#...#
#.#####.#.#######.#.#.###.#.###.#.#####.#####.#.#######.#########.#.#.#####.###.#.#.#####.#########.#.#.#.###.###.###.#.#.#######.#.###.###.#
#.....#.#...#.....#.#.#...#...#.#.....#.....#...#.................#.#.#...#...#.#.#.#...#...........#.#.#...#...#.#...#.....................#
#####.#.#.#.#.#####.#.#.#.#.#.#.#####.#####.###########.#.#.#.#####.###.#.#.#.#.###.#.#.#######.###.#.#.#####.#.#.#.###.#.#.###.#.#.#.#####.#
#...#.#...#.#.....#.#.#.#.#.#.#...#.#.#...#.#.......#...#.#.#.#.....#...#.#.#.#...#.#.......#...#.....#.....#.#.............#.#.....#.....#.#
#.###.###.#######.#.#.#.#.#.#####.#.#.###.#.#.#.###.#.###.#.#.#.#####.###.###.###.#.#######.#.###.#.#######.#.#####.#.###.#.#.###.#.#####.#.#
#.....#.#.........#.#...#.#.....#.#.#.........................#...#...#...#...#...#.................#.....#...#...#.#.....#...#...........#.#
#.#####.#############.###.#####.#.#.#####.#.#.###.###############.###.#.###.###.###.#.#########.###.#.###.###.#.#.#.#.#######.#.#.#.#######.#
#S............................#...#.......#.....#.....................#.....#.......#.............#.....#.......#...........................#
#############################################################################################################################################