........
.S----7.
.|L--J|.
.||..||.
.|J--L|.
.L----J.
........
