\.........../.............../.......\...........................\./.........................|....../.|.......-
....-.........../|......|.......-.......................................................................\./...
-....-...-...........-................|..-..-.-......./.................\.-.......\/-..-..............\.......
...\....-.|.....\.|......./.../...\......|....................................................................
...|..........|.........|........|......|..........................-.../.../...............|.......-.....|....
\......................../.\..............\..|................/..|........./..-................./..\..........
..|..|.....\.....................|.................-...-............................../......\.....\..........
|-.............................../../|...............\.....|..\......................\...........-...-........
|..............\..../........../.....|./.....\........./...........|.....-.../........|....\......|..........|
.|................\....../.....|...........\........\|....-...............-......|........|...................
......\..........................................\...../.....|.../..................-....../..................
.\....\..................\..\......-.............|.........|...................................../-|.....-....
\................/.........-....-......../....|..|/...................\|.\...............-....-............../
.....................\...........-....\......\............||.....-.......\.\.......................\...|.../..
..................|......./....\...-..................|...|/..........................................\.......
..\...................../...................--.................-......../............./..|.......\|.\.|..\|...
...-../....|........../.....\..........-........................../.............................-.......\.-...
../.......|........................-....../........................................./.|...|...........|...\...
.....-./..........................................|........\....\................/.......-...|....-...........
................|..../..|...................-...............\/..|.........................................\...
...........-...\.|..-.\.-.......-./.....\../..-\..-...|........./.............-..........................-...\
.........\../........-.|........|............../....\........|..........|......|../........../...........\....
..|...........................|.............\........\................../.................../......\....\|....
....................-........................//\............../...........-........-........\................/
......./..............|/..|.../............/.-...........-.............................\............../.......
.../............/...|....|\.....-.-..|.......\...|..........-.........\\..........-.-.../......./...../\......
......|/\./.....\..................................|...|.............................................|...-....
............./.|........................................|...\.......-......................../.........\...-..
....................../...\.........\.....................................-.........................\.........
.............\.../....|..................-.|-.-/....|.....-./.......\.......|../..............................
...||...\......./.........\|.\..\....|....../.......\.........-.\.............../.......................\....|
.|......-...............-..||......|../..............................\.../...........-.................|......
.........\/............-....................................|..................................../....\.......
..\........\.-/......|/..//........./.......|./............-./.......................\.-.........../..........
...|..../....|............./|......-..........|..-......................../...\.........../........-...|......
......................../\.....|.................|..........\............-|.........................-.\.......
.........................|..\.\........../..........................................\........................|
-..-......./.................\....|...........-...-.......|...|.....|..|...|........|.\.......................
.......-................./.....................\..|....\......-...|.\.....|.\../..................|......|....
..../....................-....\......-.../.........../........|...././.............-....\............./.......
..|...|..................\.-..............|............\../.................-...............|..|....|.........
..........-....\|.........|.......................|................................\.....--..-.............\..
..........................\...../....-/........................|......................../.\...................
...\................\...........................................\........./............/.......\-......\......
-......./.......................\\................................./|..................\....|...|..-..........
....../..........................\.....\...........\..................\..../...\......\........|...../..../...
..-.........-../....-......-.........../..........-......................\........./......................./..
.......|-..\.......|.....-.........-............-/........../.....\\.............................\./..........
/.-.........../.................................-............./.\....................\....|....\..............
............\......................./../............/.........|../.-.\...................|../.................
../....|................|..\..............\..............................-............./../..|................
...\...............-..........-.....-\...............\..\.//-......./.../|.......|..|.-.........\....\.....-..
.........-........\...........-..................................-...................../.....................|
.\.........-.........|./-.-\.-...........|.../...........|....-..........|-..-...............................\
...........\.../......./..........|.....|.../...............-..................|/....|..........//......--....
.....-.........................................................|..../..|.-......../-......./....|..|..........
.........-..................-..................../..\....................-|......\......................\.....
..........................-.\...|......-...|..-......-./.......-............/....\..............\.......\.....
..-.-.............\............/........../.....................-/.................-./.|/.....................
............\...|...../.|....|...|......|..........|................................\...................\.....
.../....\....../.../...-............./../............./..................//....||...../.........-......-......
..../|..............\-../...-\.\.........../............................../...........-................-...|./
..../|........\......-.................................../........../................-.\|../.........../......
......../.\\...............|..\..........|......|...............-.-.......................|.........\.........
.......|..\..|/........................................................\.......\....|...\...\...........|.....
........./.....\|....................................\..........\\/.......\../\..\\//......-..................
.........|........................................|.....|...........|.../............|....-..-.\\.|...........
.|.................|.........\...............................\..../....\.....\..../..|.......\.......|........
.....|.....-............/........................|.................................................-..........
\.....|.................................\.|.......\................................./.........|.\.............
............................................................/.........\.......................................
..................../.\...//|................./...|./...\|....\\..|.........-.....-.-.........../.../...\.....
.............-........................\...............................-\./...........\........../....\........
.....................|.....|.......................|.....|........../........-...../............|.......\.....
/.-..........................\......../.......\../.....-.......-........................|-...../..............
./...\..\...................|....../..........-................./............./.\..\.......|.\................
....-....\........|...../..-................\|........|........................./\............\......--.\.....
....\../................/.......\.......-.............|.........-.......-..\..................-...............
-......|...................|............................................................................../...
.............../...........\........................|.........../...\..-...........|...........|.....|........
......-....................-........--...|...............//.../.\.|..//...../..............-..\./..\..........
.......\.\................................\......\..|..............\.\.......\.../............../......\...-..
.....|......./../-...../../.../....................\..............|..............\......\....\.\.|............
........|-..........\........................|.......|..-.................|....\...........................\\.
./...............\..............|/................................|.........\......................\..........
.\...........|-..-................-.........../...................................../.....\...................
.-.......|../.........|........|...............................|....../......\....|.........\/....../.........
\.............|................|..../............-.....................\..\.....-|.....-.....|................
............../...\....\/......-.....................................-....-...................|...../.........
........./.............\.............................|.........-..........-.........-.........\.........-.....
.............../.....-...\..\.........\....-......./....\...............\......\-..../........................
.|.......-.|......................|......-....|\|......|...|..............\..........-...\.........|..........
.................../........./..........\../..................../...............|..\.......--.......\.........
..............-..../...................-..../../............-/..|.........................-......|............
.|....|........................|..\............|....-..../|............-.|.|..................|...............
.......//.....\..............|../..............................-...........\|..-..................\....|..|../
........-................|............../....|....-..............-...............|.......\..............|./\..
.............................|.|....../.........../.....\....|.............../...................\.....|......
...../...............|........../../..\..................\/..........................-......-........\..|.....
....../....................../..............\...\.......-.....|/.........-....................................
...........-.\./.../..\.........................\..................................../..|.............-.......
.......|............|............/......................|.\............/....\.\..........-.....-.......-.-....
..............\.....-.\..\....-.../............................-.........|.|...........................|..\...
.../...\..................|........../../..../............./..\..................................|............
..--....|.................................................-..........|../....|.../....../................./...
........./.....................\...................../.|\....||..-../.....-.|.........................-.......
............./......./.....\.........\....-.............-..........\....................-...\.....|...../...-.
..../.-..........\.......\..|.............|........|..-............................./.|............./...-....-
....../....../.....................\......-.........\..........-....\......-............\.|...................
.............................\................\.......-.......................|......|........................